R 848 480
NO ./textures/christmas_blue_256.xpm
SO ./textures/christmas_red_256.xpm
WE ./textures/christmas_brown_256.xpm
EA ./textures/christmas_green_256.xpm

S ./textures/snowman_256.xpm
F 200,200,200
C 250,250,250

    11
    101
 11111111        1  
  100200011111  101
 10020011      1001
1000000111    1011
1111000020111111111
    1N0002000001
111111111111111111
   101
    1